1 EEE EEE ECE FFF S
2 EEE EEE ECE FFF S
3 EEE ECE OOO FFF S
4 EEE EEE EEE FFF S
5 EEE EEE EEE FFF R
6 EEE CEE EEE FFF S
7 CEE EEE OOO FFF S
8 EEE CEE EEE FFF S
9 EEE CEE EEE FEE S
10 EEE EEE EEE FFF S
11 EEE EEE EEE FFF L
12 EEE ECE EEE FFF S
13 EEE OOO ECE FFF S
14 EEE EEE EEE FFF S
15 EEE EEC EEE FFF S
16 EEB EEE EEE FEE S
17 EEE EEC EEE FFF S
18 EEE EEC EEE FFF S
19 EEE EEC EEE FFF L
20 EEE EEE EEE FFF S
21 EEE EEE 000 FFF S
22 EEE EEE EEE FFF S
23 EEE BEE EEE FFF S
24 OOO OOO EEE FFF S
25 EEE ECE EEE FFF S
26 EEE ECE EEE FFF S
27 EEE CEE EEE FFF S
28 CEE EEE OOE FFF S
29 EEE CEE EEE FFF S
30 EEE EEB EEE FFF S
31 EEE EEE EEE FFF S
32 EEE EEE EEE FFF R
33 EEE EEE EEE FFF S
34 EEE EEE EEE EEE S
35 EEE EEE EEE FFF S
36 EEE EEE OOO FFF S
37 EEE ECE EEE FFF S
38 EEE EEE EEE FFF L
39 EEE EEC EOE FFF S
40 EEE EEE EEE FFF S
