1 EEE EEE EEE FFF S
2 EEE EEE EEE FFF S
3 EEE EEE EEE FFF S
4 EEE EEE EEE EEE S
5 EEE EEE EEE FFF S
6 EEE EEE EEE FFF S
7 EEE EEE EEE FFF S
8 EEE EEE EEE FEE S
9 EEE EEE EEE FFF S
10 EEE EEE EEE FFF S
11 EEE EEE EEE EFF S
12 EEE EEE EEE FFF S