1 EEE EEE ECE FFF S
2 EEE EEE ECE FFF S
3 EEE EEE 000 FFF S
4 EEE EEE ECE FFF S
5 EEE EEE ECE FFF S
6 OOO OOO OEO FFF S
7 EEE EEE ECE FFF S
8 EBE EEE EEE EEE S
9 EEE EEE ECE FFF S
10 EEE EEE EEE FFF R
11 EEE EEE EEC FFF S
12 EEE EEE EEC FFF S
13 EEE EEE ECE FFF S
14 EEE EEE 000 FFF S
15 EEE EEE EEE FFF S
16 OOO OOO EEE FFF S
17 EEE EEE ECE FFF S
18 EEE EEE ECE FFF L
19 EEE EEE ECE FFF S
20 EEE OOE OOE FFF S
21 EEE EEE EEE FFF S
22 EEB EEE EEE EEE S
23 EEE EEE EEE FFF S
24 EEE EEE ECE FFF S
25 ECE EEE EEE EEE S
26 EEE EEE ECE FFF S
27 EEC EEE EEE EEF S
28 EEE EEE EEC FFF S
29 EBE EEE EEE EEE S
30 EEE EEE EEE FFF S
31 OOO OOO EEE FFF S
32 EEE EEE CEE FFF S
33 EEE EEE CEE FFF S
34 EEE EEE CEE FFF R
35 EEE EEE CEE FFF S
36 OEO OEO OOO FFF S
37 EEE EEE EEC FFF S
38 EEC EEE EEE FEE S
39 EEE EEE EEC FFF S
40 EEE EBE EEE FFF S
