1 EEE EEE EEE FFF S
2 EEE EEE EEE FFF S
3 EEE EEE EEE FFF S
4 EEE EEE HHH FFF S
5 EEE EEE EEE FFF S
6 EEE EEC EEE FFF L
7 EEE EEC EEE FFF S
8 EEE EEC HHH FFF S
9 EEE EEC EEE FFF S
10 EEE EEC EEE FFF S
11 EEE CEE EEE FEE S
12 EEE EEE EEE FFF S
13 EEE EEE EEE FFF S
14 EEE EEE OOO FFF S
15 EEE EEE EEE FFF S
16 OOO OOO EEE FFF S
17 EEE CEE EEE FFF S
18 EEE CEE EEE FFF R
19 EEE CEE EEE FFF S
20 CEE EEE EEE EEE S
21 EEE CEE EEE FFF S
22 EEE EEE EEE FFF S
23 EEE EEE EEE FFF S
24 EEE EBE EEE FEE S
25 EEE CEE EEE FFF L
26 EEE CEE EEE FFF S
27 EEE CEE EEE FFF S
28 EEE CEE EEE FFF S
29 EEE CEE OOO FFF S
30 EEE CEE EEE FFF S
31 EEE EEE EEE FFF S
32 EEE EEE EEE FFF S
33 EEE EEE EEE FFF S
34 EEE EEE HHH FFF S
35 EEE EEE EEE FFF S
36 EEE EEC HHH FFF R
37 EEE EEC EEE FFF S
38 EEE EEC HHH FFF S
39 EEE EEC EEE FFF S
40 EEE EEC EEE FFF S
41 EEE CEE EEE FEE S
42 EEE EEE EEE FFF S
43 EEE EEE EEE FFF S
44 EEE EEE OOO FFF S
45 EEE EEE EEE FFF S
46 OOO OOO EEE FFF S
47 EEE CEE EEE FFF S
48 EEE CEE EEE FFF L
49 EEE CEE EEE FFF S
50 CEE EEE EEE EEE S
51 EEE CEE EEE FFF S
52 EEE EEE EEE FFF S
53 EEE EEE EEE FFF S
54 EEE EBE EEE FEE S
55 EEE CEE EEE FFF R
56 EEE CEE EEE FFF S
57 EEE CEE EEE FFF S
58 EEE CEE EEE FFF S
59 EEE CEE OOO FFF S
60 EEE CEE OOO FFF S