1 EEE EEE EEE FFF S
2 EEE ECE EEE FFF S
3 EEE ECE EEE FFF S
4 EEE EEE HHH FFF S
5 EEE EEC EEE FFF S
6 EEE EEC HHH FFF S
7 EEE EEC EEE FFF S
8 ECE EEE HHH FFF S
9 EEE EEE EEE FFF S
10 EEE EEE EEE FFF S
11 EEE EEE EEE FFF S
12 EEE CEE EEE FFF S
13 EEE CEE EEE FFF S
14 EEE CEB EEE FFF S
15 EEE CEE EEE FFF S
16 EEE EEE EEE FFF L
17 EEE EEE EEE FFF S
18 EEE EEE OOO FFF S
19 EEE EEC EEE FFF S
20 EEE EEC EEE FFF S
21 EEE EEC EEE EEF S
22 EEE EEE EEE FFF S
23 EBE EEE EEE FFF S
24 EEE CEE EEE FFF S
25 EEE EEE EEE FFF R
26 EEE CEE EEE FFF S
27 EEE CEE EEE FFF S
28 CEE EEE EEE FFF S
29 EEE CEE EEE FFF S
30 OOO OOO EEE FFF S
31 EEE EEE EEE FFF L
32 EEE ECE EEE FFF S
33 EEE ECE EEE EFE S
34 EEE ECE EEE FFF S
35 EEE EOO EOO FFF S
36 EEE EEE EEE FFF S
37 EBE EEE EEE FFF S
38 EEE EEC EEE FFF S
39 EEE EEC OOO FFF S
40 EEE EEE EEE FFF S
