1 EEE EEE EEE FFF S
2 EEE EEE EEE FFF S
3 EEE EEE EEE FFF S
4 EEE EBE EEE FFF S
5 EEE EEE EEE FFF S
6 EEE EEC EEE FFF S
7 EEE EEC EEE FFF S
8 EEE EEC EEE FFF S
9 EEE EEC EEE FFF S
10 EEE EEC EEE FFF S
11 EEE CEE EEE FFF S
12 EEE EEE EEE EEE S
13 EEE EEE EEE FFF S
14 EEE EEE EEE FFF S
15 EEE EEE EEE FFF S
16 OOO EEE EEE FFF S
17 EEE CEE EEE FFF S
18 EEE CEE EEE FFF S
19 EEE CEE EEE FFF S
20 EEE EEE EEE FFF S
21 EEE CEE EEE FFF S
22 EEE EEE EEE FFF S
23 EEE EEE EEE FFF S
24 EEE EBE EEE FEF S
25 EEE CEE EEE FFF S
26 EEE CEE EEE FFF S
27 EEE CEE EEE FFF S
28 EEE CEE EEE FFF S
29 EEE CEE OOO FFF S
30 EEE CEE OOO FFF S