1 EEE EEE EEE FFF S
2 EEE ECE EEE FFF S
3 EEE ECE EEE FFF S
4 EEE ECE EEE FFF S
5 EEE EEC EEE FFF S
6 EEE EEC EEE FFF S
7 EEE EEC EEE FFF S
8 ECE EEE EEE EEE S
9 EEE EEE EEE FFF S
10 EEE EEE EEE FFF S
11 EEE EEE EEE FFF S
12 EEE CEE EEE FFF S
13 EEE CEE EEE FFF S
14 EEE CEB EEE FFF S
15 EEE CEE EEE FFF S
16 EEE EEE EEE FFF L
17 EEE EEE EEE FFF S
18 EEE EEE OOO FFF S
19 EEE EEC EEE FFF S
20 EEE EEC EEE FFF S
21 EEE EEC EEE EEF S
22 EEE EEE EEE FFF S
23 EBE EEE EEE FFF S
24 EEE CEE EEE FFF S
25 EEE EEE EEE FFF R
26 EEE CEE EEE FFF S
27 EEE CEE EEE FFF S
28 CEE EEE EEE FFF S
29 EEE CEE EEE FFF S
30 OOO OOO EEE FFF S
31 EEE EEE EEE FFF L
32 EEE ECE EEE FFF S
33 EEE ECE EEE EFE S
34 EEE ECE EEE FFF S
35 EEE EOO EOO FFF S
36 EEE EEE EEE FFF S
37 EBE EEE EEE FFF S
38 EEE EEC EEE FFF S
39 EEE EEC OOO FFF S
40 EEE EEE EEE FFF S
41 EEE EEE EEE FFF S
42 EEE ECE EEE FFF S
43 EEE ECE EEE FFF S
44 EEE ECE EEE FFF S
45 EEE EEC EEE FFF S
46 EEE EEC EEE FFF S
47 EEE EEC EEE FFF S
48 ECE EEE EEE EEE S
49 EEE EEE EEE FFF S
50 EEE EEE EEE FFF S
51 EEE EEE EEE FFF L
52 EEE ECE EEE FFF S
53 EEE ECE EEE EFE S
54 EEE ECE EEE FFF S
55 EEE EOO EOO FFF S
56 EEE EEE EEE FFF S
57 EBE EEE EEE FFF S
58 EEE EEC EEE FFF S
59 EEE EEC OOO FFF S
60 EEE EEE EEE FFF S
61 EEE EEE EEE FFF S
62 EEE CEE EEE FFF S
63 EEE CEE EEE FFF S
64 EEE CEB EEE FFF S
65 EEE CEE EEE FFF S
66 EEE EEE EEE FFF L
67 EEE EEE EEE FFF S
68 EEE EEE OOO FFF S
69 EEE EEC EEE FFF S
70 EEE CEE EEE FFF S
71 EEE CEE EEE FFF S
72 CEE EEE EEE FFF S
74 EEE CEE EEE FFF S
75 OOO OOO EEE FFF S
