1 VVV VVV VVV PPP T
2 VVV VVV VVV PPP T
3 VVV VVV VVV PPP T
4 VVV VVV VVV PPP T
5 VVV VVV VVV PPP T
6 VVV VVC VVV PPP G
7 VVV VVC VVV PPP T
8 VVV VVC VVV PPP T
9 VVV VVC VVV PPP T
10 VVV VVC VVV PPP T
11 VVV CVV VVV PVV T
12 VVV VVV VVV PPP T
13 VVV VVV VVV PPP T
14 VVV VVV OOO PPP T
15 VVV VVV VVV PPP T
16 OOO OOO VVV PPP T
17 VVV CVV VVV PPP T
18 VVV CVV VVV PPP D
19 VVV CVV VVV PPP T
20 CVV VVV VVV VVV T
21 VVV CVV VVV PPP T
22 VVV VVV VVV PPP T
23 VVV VVV VVV PPP T
24 VVV VBV VVV PVV T
25 VVV CVV VVV PPP G
26 VVV CVV VVV PPP T
27 VVV CVV VVV PPP T
28 VVV CVV VVV PPP T
29 VVV CVV OOO PPP T
30 VVV CVV OOO PPP T